1111111111111111111111111111111111111111111111
1.............................................
1.............................................
1.............................................
1.............................................
1.............................................
1.............................................
1.............................................
1.............................................
1.............................................
1.............................................
1.............................................
1.............................................
1.............................................
1..P..........................................
11111111....11111111....1111111111111111111111
.......1....1......1....1.....................
.......1....1......1....1.....................
.......1....1......1....1.....................
.......1....1......1....1.....................
.......1....1......1....1.....................
.......1....1......1....1.....................
.......1....1......1....1.....................
.......1....1......1....1.....................
.......1....1......1....1.....................
.......1....1......1....1.....................
.......1....1......1....1.....................
.......1....1......1....1.....................
